6
6
5
1
4
6
111101
100001
131201
100101
110011
111011